14 11
.........T.
XX...XX....
X..........
XXXXXXX....
....XG.....
XX..XGX....
....XXX....
XX...XX.K..
S..........
XX...XX....
...........
XXX.....XXX
XG.......GX
XXXXXXXXXXX
