20 21
XXXXXXXXXXTXXXXXXXXXX
X.........G.........X
....X...........X....
XX..XXXXXX.XXXXXX..XX
XX.....XXX.XXX..X..XX
XX.....XX...XX.....XX
XXXX...XX...XX...XXXX
.....................
......XXX.....XXX....
XXXX..XXX..G..XXXXX..
..............XXX....
..XX..XXXXXXXXXXX..XX
......XXX.....XXX....
.....................
XXX...XXX.....XXX....
K.....XXX.......X....
XXXX..XXX.......X...G
X.....XXX.....XXXXXXX
..XXXXXXX............
..G...XXXXXXXXXXX...S
